{
    "tileset":"res/tilesets/field1/ts.json",
    "attributes":{"width":8, "height":8},
    "field":[
        [0, 0, 1, 0, 0, 0, 0, 0],
        [0, 0, 1, 0, 1, 1, 0, 0],
        [0, 1, 1, 0, 1, 1, 1, 0],
        [0, 1, 0, 0, 0, 0, 0, 0],
        [0, 1, 1, 0, 0, 0, 0, 0],
        [0, 0, 1, 1, 0, 0, 1, 1],
        [0, 0, 0, 1, 1, 1, 1, 0],
        [0, 0, 0, 0, 0, 0, 0, 0] 
    ]
}
