{
    "tileset":"res/tilesets/field1/ts.json",
    "attributes":{"width":16, "height":16},
    "field":[
        [1, 1, 1, 1, 1, 1, 1, 1, 1, 1, 1, 1, 1, 1, 1, 1],
        [1, 1, 1, 1, 1, 1, 1, 1, 1, 10,11,11,11,12,1, 1],
        [1, 1, 1, 1, 1, 1, 1, 1, 1, 8, 0, 0, 0, 13,12,1],
        [1, 1, 1, 1, 1, 10,11,11,11,16,0, 0, 0, 0, 2, 1],
        [1, 1, 1, 1, 1, 8, 0, 0, 0, 14,0, 0, 0, 0, 2, 1],
        [1, 1, 1, 1, 10,9, 0, 0, 0, 15,7, 0, 0, 0, 2, 1],
        [1, 1, 1, 1, 8, 0, 0, 0, 0, 2, 6, 5, 5, 5, 3, 1],
        [1, 1, 1, 1, 8, 0, 0, 0, 0, 2, 1, 1, 1, 1, 1, 1],
        [1, 1, 1, 1, 6, 7, 0, 0, 4, 3, 1, 1, 1, 1, 1, 1],
        [1, 1, 1, 1, 1, 6, 5, 5, 3, 1, 1, 1, 1, 1, 1, 1],
        [1, 1, 1, 1, 1, 1, 1, 1, 1, 1, 1, 1, 1, 1, 1, 1],
        [1, 1, 1, 1, 1, 1, 1, 1, 1, 1, 1, 1, 1, 1, 1, 1],
        [1, 1, 1, 1, 1, 1, 1, 1, 1, 1, 1, 1, 1, 1, 1, 1],
        [1, 1, 1, 1, 1, 1, 1, 1, 1, 1, 1, 1, 1, 1, 1, 1],
        [1, 1, 1, 1, 1, 1, 1, 1, 1, 1, 1, 1, 1, 1, 1, 1],
        [1, 1, 1, 1, 1, 1, 1, 1, 1, 1, 1, 1, 1, 1, 1, 1]
    ]
}
