{
    "tileset":"res/tilesets/field1/ts.json",
    "attributes":{"width":16, "height":16},
    "field":[
        [0, 0, 0, 0, 0, 0, 0, 0, 2, 8, 0, 0, 0, 0, 0, 0],
        [0, 0, 0, 0, 0, 0, 0, 0, 2, 8, 0, 0, 0, 0, 0, 0],
        [0, 0, 0, 0, 0, 0, 0, 0,13,19,18, 0, 0, 0, 0, 0],
        [0, 0, 0, 0, 0, 0, 0, 0, 0, 0,14, 0, 0, 0, 0, 0],
        [0, 0, 0, 0, 0, 0, 0, 0, 0, 0,15, 7, 0, 0, 0, 0],
        [0, 0, 0, 0, 0, 0, 0, 0, 0, 0, 2, 8, 0, 0, 0, 0],
        [0, 0, 0, 0, 0, 0, 0, 0, 0, 4,22, 9, 0, 0, 0, 0],
        [0, 0, 0, 0, 0, 0, 4, 5, 5, 3, 8, 0, 0, 0, 0, 0],
        [0, 0, 0, 0, 0, 4,10,11,11,11,19,18, 0, 0, 0, 0],
        [0, 0, 0, 0, 0, 2, 8, 0, 0, 0, 0,20,21,21,21,21],
        [0, 0, 0, 0, 4,22, 9, 0, 0, 0, 0, 0, 0, 0, 0, 0],
        [0, 0, 0, 0, 2, 8, 0, 0, 0, 0, 0, 0, 0, 0, 0, 0],
        [0, 0, 0, 0, 2, 9, 0, 0, 0, 0, 0, 0, 0, 0, 0, 0],
        [0, 0, 0, 1, 1, 0, 0, 0, 0, 0, 0, 0, 0, 0, 0, 0],
        [0, 0, 1, 1, 1, 0, 0, 0, 0, 0, 0, 0, 0, 0, 0, 0],
        [0, 0, 1, 1, 1, 0, 0, 0, 0, 0, 0, 0, 0, 0, 0, 0]
    ]
}
